NO ./textures/donut.png
SO ./textures/donut.png
WE ./textures/donut.png
EA ./textures/donut.png

F 155,094,50
C 211,116,206

                                
           1111111111            
       111110000000011111        
     1110000000000000000111      
    110000000000000000000011     
   1100000011111111100000001    
  1100000011       1100000011  
  10000011          110000001
 11000011            11000001
 1000011             11000001
 1000011             11000001
 1000011             11000001
 1000011             11000001
 1000011             11000001
 10000011           110000001
 110000011          110000001
  100000011       11000000111
  1100000011111111100000001
   110000000000000000000011
    1100000000000000000011
     1110000000N000000111
       11111000000001111
           1111111111