NO ./textures/retr0.png
SO ./textures/retr0.png
WE ./textures/retr0.png
EA ./textures/retr0.png

F 15,71,22
C 139,172,15

     1111111
     1000001
     100S001
     1000001
     1110111
       101
       101
       101
       101111111111111111111111111111
       100011000000100000000000001001
       100011000000000000000000100001
       100011000000111111111111100001
       100011000000111000000000100001
       100011000000111010000000100001
       100000000000111000000100100001
       100000111000111000000000100001
       100000111000111111111110100001
       100000111000000000000000100001
       100000111000100000000000001001
       111111111111111111111111111111
