NO ./textures/vines_01.png
SO ./textures/vines_01.png
WE ./textures/vines_02.png
EA ./textures/vines_02.png

F 4,26,007
C 0,00,000

     1111111
     1000001
     100S001
     1000001
     1110111
       101
       101
       101
       101111111111111111111111111111111111111111111111111111
       101000100001110001111000011111111011000110000000000001
       100101101101010101111011001001000011010110000000000001
       101100000000001101111010100011010111010110000000000001
       101011011101100000011010101001001000010110000000000001
       101011011001101111011010101111011111010110000000000001
       100010011001100011011010100000000000010110000000000001
       101100111001001011011010101110111111110010000000000001
       101011000011011011011000101000110001111110000000000001
       100011011000011001011111101011010100000000000000000001
       101010000011001111000000001000000111111110000000000001
       111111111111111111111111111111111111111111111111111111



