NO ./textures/whale_stomach.png
SO ./textures/whale_stomach.png
WE ./textures/whale_stomach.png
EA ./textures/whale_stomach.png

F 139,172,15
C 56,223,223

       11111111111111111111111                                              
  11111100000000000000000000011111111111111111                                     11111
 11000000000000000000000000000000000000000000111111111111111                    11110001
 10000000000000000000011111110000000000000000000000000000001111111111111111    110000011
11000000000000000000111111111110000000000000000000000000000000000000000000111 110000011
10000000000000000000111111111110000000000000000000000000000000000000000000001110000111
10W000000000000000111111111111100000000000000000000000000000000000000000000000000111
10000000000000000000111111111110000000000000000000000000000000000000000000001110000111
11000000000000000000111111111110000000000000000000000000000000000000000000111 110000011
 10000000000000000000011111110000000000000000000000000000001111111111111111    110000011
 11000000000000000000000000000000000000000000111111111111111                    11110001
  11111100000000000000000000011111111111111111                                     11111
       11111111111111111111111                                              
                                 