NO ./textures/no.png
SO ./textures/so.png
WE ./textures/we.png
EA ./textures/ea.png

F 220,100,0
C 225,30,0

11111
1 N 1
11111
